Code,Total,Recent,Prev,Change,Rockets,Price,PrvCls,%Change,Volume,3mAvgVol,%ChangeVol,Float,Industry
SENS,32,32,0,32,27,1.2,0.8896,34.892,47464895,6669579,611.663,114087574,Diagnostics & Research
OZSC,47,25,22,3,0,0.0347,0.0423,-17.967,600365329,93877543,539.520,N/A,Medical Instruments & Supplies
CLWD,24,24,0,24,0,0.12005,0.169,-28.964,182141762,29778889,511.647,607040122,Software—Application
GSAT,18,5,13,-8,0,0.93,0.842,10.451,48325500,9507855,408.269,513198613,Telecom Services
BIG,23,23,0,23,21,52.18,48.19,8.280,2297895,1368153,67.956,36354456,Discount Stores
EXPR,19,14,5,9,0,1.28,1.03,24.272,50529421,5246207,863.161,54792960,Apparel Retail
TLSS,55,50,5,45,0,0.06295,0.089,-29.270,281971660,39675361,610.697,1557067013,Trucking
IONI,33,33,0,33,0,0.75,0.4301,74.378,6885474,163263,4117.412,21216475,Software—Application
DPW,20,10,10,0,0,5.6,4.19,33.652,66642825,11260974,491.803,16304692,Electrical Equipment & Parts
ADMP,10,10,0,10,0,0.8077,0.7512,7.521,12439654,5320782,133.794,92574946,Drug Manufacturers—Specialty & Generic
CTRM,34,34,0,34,0,0.36,0.372,-3.226,279986938,55013380,408.943,130485459,Marine Shipping
EMBI,22,22,0,22,0,0.0885,0.1,-11.500,12606007,3605184,249.663,117092343,Biotechnology
ZOM,47,42,5,37,5,1.01,0.976,3.484,317432134,121972476,160.249,501007409,Drug Manufacturers—Specialty & Generic
CBBT,31,21,10,11,0,0.123,0.0998,23.246,27091272,27553271,-1.677,139831874,Biotechnology
HUGE,48,48,0,48,21,2.1,2.01,4.478,730997,965917,-24.321,16094672,Drug Manufacturers—Specialty & Generic
MNXXF,62,31,31,0,7,0.381112,0.2129,79.010,2939864,449400,554.175,105179740,Other Industrial Metals & Mining
TANH,113,108,5,103,22,1.97,1.69,16.568,15464662,3923773,294.127,19392496,Household & Personal Products
BNGO,32,20,12,8,0,6.95,5.63,23.446,235016091,54746949,329.277,150989313,Diagnostics & Research
FRSX,10,5,5,0,0,6.58,6.8,-3.235,38861386,10303542,277.165,32365360,Auto Parts
AAU,12,12,0,12,1,0.6314,0.65,-2.862,15703728,1577169,895.691,114963594,Gold
LXRX,26,19,7,12,0,8.05,3.92,105.357,160260602,7923901,1922.496,107118229,Biotechnology
VISL,15,5,10,-5,0,1.92,1.78,7.865,28445600,3152107,802.431,20796583,Communication Equipment
OGEN,22,17,5,12,1,0.95,0.7684,23.633,207576916,14258031,1355.860,57104263,Biotechnology
TRXC,17,17,0,17,0,1.99,1.74,14.368,56497382,11525368,390.200,79392704,Medical Devices
IDEX,20,10,10,0,0,3.3,2.71,21.771,135387431,39803057,240.143,200267564,Software—Application
IZEA,20,10,10,0,0,3.19,2.59,23.166,12890804,5004714,157.573,45356907,Internet Content & Information
BOXL,12,12,0,12,0,2.09,1.82,14.835,13133521,3486426,276.704,44821222,Communication Equipment
ASTI,19,19,0,19,3,0.008735,0.0075,16.467,183834685,106208253,73.089,4031273622,Solar
NAKD,10,10,0,10,0,0.4686,0.466,0.558,130893564,137249841,-4.631,41611144,Apparel Manufacturing
ATVK,59,29,30,-1,0,0.241,0.18405,30.943,30598014,20766363,47.344,64874451,Specialty Industrial Machinery
GME,11,6,5,1,0,39.91,31.4,27.102,93717410,12153046,671.143,46920872,Specialty Retail
MJLB,10,10,0,10,2,0.074,0.056,32.143,12336895,13410211,-8.004,N/A,Scientific & Technical Instruments
BTCS,10,10,0,10,3,3.06,1.73,76.879,11444383,2496322,358.450,36837774,Capital Markets
WWR,10,5,5,0,0,4.98,5.13,-2.924,7368568,7338426,0.411,15776540,Other Industrial Metals & Mining
TSNP,10,5,5,0,0,0.2189,0.1995,9.724,49403091,225926456,-78.133,N/A,"Furnishings, Fixtures & Appliances"
ARSMF,10,10,0,10,0,0.4061,0.4523,-10.214,562263,224850,150.061,66946701,Other Industrial Metals & Mining
ALPP,13,13,0,13,0,2.72,2.45,11.020,1780612,3916514,-54.536,110944403,Electronic Components
DSCR,14,14,0,14,0,0.00095,0.0007,35.714,658888631,67411822,877.408,N/A,Other Precious Metals & Mining
TSCRF,28,28,0,28,0,2.17,1.71,26.901,3681898,1379985,166.807,262164967,Electronic Gaming & Multimedia
OBSV,19,19,0,19,0,2.52,2.11,19.431,17851509,935407,1808.422,37697945,Biotechnology
UNQL,13,13,0,13,0,0.16,0.131555,21.622,345274,N/A,N/A,0,0
MARA,24,5,19,-14,0,24.44,23.0,6.261,55343591,33182282,66.787,45979027,Capital Markets
AGEEF,10,5,5,0,0,0.0796,0.095,-16.211,10616815,2353984,351.015,963156561,Drug Manufacturers—Specialty & Generic
MGTI,10,5,5,0,0,0.193,0.2121,-9.005,33531449,14600830,129.654,502279577,Capital Markets
TNXP,83,51,32,19,29,0.9564,0.9999,-4.350,49120772,18228650,169.470,156426899,Biotechnology
RSI,11,6,5,1,0,23.36,22.5,3.822,950547,1329780,-28.518,N/A,Gambling
SNDL,38,27,11,16,3,0.6902,0.6578,4.926,311980169,291392006,7.065,435150917,Drug Manufacturers—Specialty & Generic
NEBLQ,10,10,0,10,0,0.082,0.035,134.286,37473395,2324976,1511.776,249544828,Oil & Gas Drilling
AABB,36,17,19,-2,0,0.02265,0.0276,-17.935,207794999,33164134,526.565,N/A,Other Industrial Metals & Mining
TRCH,17,12,5,7,0,1.47,1.41,4.255,10579641,5241252,101.853,73036631,Oil & Gas E&P
BIOL,25,15,10,5,4,0.9141,0.92,-0.641,50777338,20561455,146.954,84361084,Medical Devices
DPLS,16,11,5,6,0,0.0015,0.0009,66.667,421236006,166034197,153.704,N/A,Software—Application
URG,25,20,5,15,0,1.19,1.11,7.207,26976482,1422823,1795.983,163971928,Uranium
NMTR,14,14,0,14,0,1.32,1.27,3.937,5235152,7159622,-26.879,116682076,Biotechnology
VBIV,13,13,0,13,0,3.22,3.08,4.545,4929098,6025060,-18.190,161850976,Biotechnology
OPTI,14,14,0,14,0,0.108,0.1048,3.053,27506217,54399828,-49.437,9588625,Auto Parts
AMPE,17,17,0,17,0,1.38,1.43,-3.497,4198104,5516473,-23.899,182469782,Biotechnology
INUV,20,20,0,20,0,0.6771,0.7268,-6.838,19008204,3999757,375.234,71382818,Advertising Agencies
DSGT,14,14,0,14,0,0.9,0.839,7.271,4500029,4385328,2.616,82904619,Scientific & Technical Instruments
SOS,10,5,5,0,3,2.77,2.33,18.884,33870214,3526128,860.550,N/A,
ENG,20,5,15,-10,0,7.53,7.25,3.862,5414756,3885565,39.356,15653643,Engineering & Construction
SRNA,13,13,0,13,0,0.1999,0.061,227.705,29200066,539734,5310.085,191508523,Farm & Heavy Construction Machinery
TRVN,12,7,5,2,0,2.18,2.22,-1.802,2351438,3815592,-38.373,155530375,Biotechnology
AVGR,10,10,0,10,0,1.11,1.13,-1.770,19118518,16526414,15.685,84593431,Medical Devices
PTE,10,5,5,0,8,1.21,1.15,5.217,22824938,4360034,423.504,23769035,Biotechnology
NCNA,10,5,5,0,0,6.5,6.4,1.562,1783914,366136,387.227,24849009,Biotechnology
PEIX,12,0,12,-12,0,7.42,7.3,1.644,3616290,6350341,-43.054,56117303,Oil & Gas Refining & Marketing
DGLY,12,0,12,-12,0,2.9,2.95,-1.695,10059489,5980247,68.212,22865484,Security & Protection Services
ARBKF,10,0,10,-10,0,1.66,1.62,2.469,8221168,10027750,-18.016,245607312,Capital Markets
PKKFF,15,0,15,-15,6,1.52,1.48883,2.094,775527,693542,11.821,97699029,Information Technology Services
ARST,10,0,10,-10,0,0.0014,0.0014,0.000,74621582,36285022,105.654,35281695,Credit Services
VRUS,10,0,10,-10,0,0.0005,0.00055,-9.091,77601857,214642,36054.088,4536104206,Food Distribution
CGC,11,0,11,-11,0,34.62,32.18,7.582,8499932,6967314,21.997,225887796,Drug Manufacturers—Specialty & Generic
NIO,10,0,10,-10,0,60.87,62.15,-2.060,96924900,189067414,-48.735,1122001693,Auto Manufacturers
PTN,10,0,10,-10,0,0.7695,0.7839,-1.837,5766550,3546839,62.583,226176906,Biotechnology
HCMC,10,0,10,-10,0,0.0001,0.0002,-50.000,1507201719,240364131,527.049,86836275981,Grocery Stores
