Code,Total,Recent,Prev,Change,Rockets,Price,PrvCls,%Change,Volume,3mAvgVol,%ChangeVol,Float,Industry
ZOM,206,138,68,70,53,1.3,0.93,39.785,890243610,100469777,786.081,501007409,Drug Manufacturers—Specialty & Generic
TNXP,205,148,57,91,45,0.925,0.815,13.497,112873561,15005660,652.207,156426899,Biotechnology
BIOL,129,91,38,53,34,1.04,0.5775,80.087,365555193,11447369,3093.356,84361084,Medical Devices
OZSC,95,74,21,53,0,0.0399,0.0244,63.525,988395564,65785275,1402.457,N/A,Medical Instruments & Supplies
CLWD,93,83,10,73,7,0.1275,0.0639,99.531,151410814,24459049,519.038,607040122,Software—Application
CTRM,85,56,29,27,8,0.293,0.258,13.566,580519801,35012685,1558.027,130485459,Marine Shipping
PTE,72,45,27,18,16,1.11,1.25,-11.200,18377881,3829384,379.917,23769035,Biotechnology
TLSS,59,34,25,9,5,0.0549,0.047,16.809,115526647,35535953,225.098,1557067013,Trucking
TTOO,59,19,40,-21,2,1.9,1.6,18.750,80285754,4022393,1895.970,140538520,Diagnostics & Research
IDEX,50,45,5,40,0,2.88,2.88,0.000,42647959,38538865,10.662,200267564,Software—Application
ATVK,49,32,17,15,0,0.217,0.205,5.854,21000174,22033866,-4.691,64874451,Specialty Industrial Machinery
OCGN,41,22,19,3,3,2.23,2.49,-10.442,27956496,44844849,-37.660,155845163,Biotechnology
ALPP,40,28,12,16,0,2.48,2.63,-5.703,1693995,4724000,-64.141,110944403,Electronic Components
CHUC,38,38,0,38,29,0.0189,0.005,278.000,211476533,5232072,3941.927,2365298236,Tobacco
SNDL,36,36,0,36,7,0.6678,0.7087,-5.771,356291768,281911877,26.384,435150917,Drug Manufacturers—Specialty & Generic
HUGE,34,28,6,22,0,2.0,2.14,-6.542,742779,946644,-21.536,16094672,Drug Manufacturers—Specialty & Generic
BNGO,33,23,10,13,15,5.36,5.67,-5.467,58787218,53053760,10.807,150989313,Diagnostics & Research
INUV,33,33,0,33,1,0.7384,0.657,12.390,18469946,3617657,410.550,71382818,Advertising Agencies
GAXY,32,27,5,22,4,0.0224,0.0248,-9.677,86352004,85771299,0.677,2241222125,Information Technology Services
OPTI,28,28,0,28,0,0.108,0.09906,9.025,101574200,52768601,92.490,9588625,Auto Parts
RECAF,25,25,0,25,0,2.57,1.95,31.795,5257615,784240,570.409,104138431,Oil & Gas E&P
AGEEF,23,18,5,13,3,0.076,0.049,55.102,5619609,2245659,150.243,963156561,Drug Manufacturers—Specialty & Generic
AVGR,23,18,5,13,2,1.16,1.45,-20.000,40852879,15672979,160.658,84593431,Medical Devices
NSPR,23,18,5,13,0,0.6497,0.6655,-2.374,22944959,4312325,432.079,34904136,Medical Devices
EMBI,22,22,0,22,0,0.063,0.046,36.957,32020472,2339798,1268.514,117092343,Biotechnology
TMBR,22,17,5,12,0,1.05,0.94,11.702,22408304,2314136,868.323,6594833,Biotechnology
BBI,21,5,16,-11,0,1.12,1.17,-4.274,6590231,3064304,115.065,51984933,Biotechnology
GSAT,20,20,0,20,0,0.8894,0.549,62.004,147077990,5180147,2739.263,513198613,Telecom Services
USWS,20,15,5,10,4,0.7731,0.52,48.673,90773203,1972653,4501.580,41813233,Oil & Gas Midstream
TRXC,20,15,5,10,0,1.61,1.66,-3.012,94832106,9615379,886.254,79392704,Medical Devices
GHSI,19,7,12,-5,0,0.6733,0.72,-6.486,27188920,18335669,48.284,76372210,Drug Manufacturers—Specialty & Generic
LMLLF,19,19,0,19,0,0.066,0.0573,15.183,221046,215189,2.722,180600740,Drug Manufacturers—Specialty & Generic
AABB,19,7,12,-5,0,0.01925,0.0216,-10.880,196153463,28086965,598.379,N/A,Other Industrial Metals & Mining
CBBT,18,13,5,8,0,0.089,0.0819,8.669,18488035,29538496,-37.410,139831874,Biotechnology
SOS,17,17,0,17,7,2.26,2.29,-1.310,8697306,3442373,152.654,N/A,
VERO,17,17,0,17,4,1.97,1.91,3.141,2022998,459304,340.449,20643770,Medical Devices
ROTH,17,5,12,-7,0,0.0005,0.0007,-28.571,1059102,92398,1046.239,N/A,
IQST,17,17,0,17,0,0.333,0.2075,60.482,19423901,3152876,516.069,58022541,Telecom Services
POWW,17,12,5,7,0,5.42,4.17,29.976,6869516,976317,603.615,38036817,Aerospace & Defense
TSLA,17,12,5,7,0,849.44,811.19,4.715,46270720,44384150,4.251,759552857,Auto Manufacturers
XELA,16,11,5,6,0,0.6333,0.575,10.139,28531646,4840841,489.394,60467885,Software—Application
TYME,16,9,7,2,0,2.15,1.72,25.000,16546845,605909,2630.913,63097186,Biotechnology
NAKD,16,11,5,6,4,0.5271,0.4085,29.033,524964092,131426796,299.435,41611144,Apparel Manufacturing
ABML,16,16,0,16,0,1.13,1.16,-2.586,3543416,16191000,-78.115,414840314,Other Industrial Metals & Mining
ALYI,15,15,0,15,0,0.02585,0.03695,-30.041,432539972,45718508,846.094,107056545,Information Technology Services
NBY,15,15,0,15,0,1.05,0.8076,30.015,18454264,1414823,1204.351,34531217,Biotechnology
XNET,15,10,5,5,0,4.12,3.71,11.051,6820369,3073166,121.933,35314187,Advertising Agencies
CARV,15,15,0,15,0,7.48,7.12,5.056,378890,362292,4.581,408691,Banks—Regional
JAGX,15,5,10,-5,0,3.38,3.6,-6.111,44591313,53253396,-16.266,63073443,Biotechnology
SUNW,14,14,0,14,0,10.91,7.95,37.233,26315707,6582704,299.770,16622008,Solar
SHIP,14,9,5,4,0,0.86,0.82,4.878,53979341,7706679,600.423,61934365,Marine Shipping
HLIX,14,14,0,14,4,0.6001,0.54,11.130,1106741,1028112,7.648,37360485,Security & Protection Services
SSET,14,14,0,14,0,0.0615,0.059,4.237,1682428,1326695,26.813,N/A,Staffing & Employment Services
ARBKF,14,0,14,-14,0,1.4,1.49,-6.040,7947720,12743250,-37.632,245607312,Capital Markets
MLFB,13,13,0,13,0,0.0059,0.005125,15.122,6061346,5923770,2.322,364383499,Leisure
LAZY,12,12,0,12,0,19.31,18.27,5.692,161783,215057,-24.772,5899467,Auto & Truck Dealerships
NAK,12,12,0,12,0,0.4831,0.4377,10.372,52261673,16666649,213.570,497241840,Other Industrial Metals & Mining
LMFA,12,12,0,12,0,1.97,2.45,-19.592,38226813,8404982,354.811,12911668,Credit Services
MJLB,12,12,0,12,0,0.0605,0.07,-13.571,18013697,12997946,38.589,N/A,Scientific & Technical Instruments
MGTI,12,12,0,12,0,0.21,0.11525,82.213,89202214,11634136,666.728,458821125,Capital Markets
ATOS,12,12,0,12,0,1.05,1.1,-4.545,15501270,4784274,224.005,9591605,Biotechnology
INND,12,7,5,2,0,0.0004,0.0003,33.333,106317480,20826308,410.496,244250786,Medical Instruments & Supplies
MARA,12,7,5,2,0,26.15,23.36,11.943,58671046,31573768,85.822,45745280,Capital Markets
HBRM,12,7,5,2,0,0.0021,0.0027,-22.222,653826523,230815038,183.269,N/A,Drug Manufacturers—Specialty & Generic
AITX,12,5,7,-2,0,0.0272,0.0265,2.642,84466339,163402802,-48.308,1117816919,Computer Hardware
ETFM,12,0,12,-12,0,0.0018,0.0023,-21.739,1725262491,0,N/A,4686667704,Auto & Truck Dealerships
SBOX,12,0,12,-12,0,0.245,0.27,-9.259,31160,30204,3.165,N/A,Conglomerates
CBPI,12,0,12,-12,0,0.045,0.05,-10.000,111878,55233,102.556,N/A,Biotechnology
ARAT,12,0,12,-12,0,1.28,1.31,-2.290,1752,5240,-66.565,N/A,Shell Companies
PLTR,12,0,12,-12,0,26.18,25.93,0.964,26645345,57677668,-53.803,1036011961,Software—Infrastructure
ACEV,12,0,12,-12,0,11.36,11.3,0.531,2742369,321665,752.554,N/A,Shell Companies
NDRA,12,0,12,-12,0,1.05,0.8999,16.680,3518286,470685,647.482,22657025,Diagnostics & Research
GEVO,12,0,12,-12,10,6.06,5.05,20.000,46220520,24776153,86.552,103457661,Specialty Chemicals
ONTX,11,6,5,1,0,0.695,0.69,0.725,20522093,23124134,-11.252,183783093,Biotechnology
IGEN,11,11,0,11,0,0.0094,0.0069,36.232,52222396,18025414,189.715,1090027221,Software—Application
ZSAN,10,10,0,10,0,0.9158,0.8612,6.340,6961879,5775914,20.533,101940677,Biotechnology
EMHLF,10,5,5,0,0,1.075,1.14,-5.702,281896,122900,129.370,113012394,Other Industrial Metals & Mining
FCEL,10,10,0,10,0,19.05,15.75,20.952,95279747,60102293,58.529,215987197,Electrical Equipment & Parts
NOVN,10,10,0,10,2,0.9904,1.01,-1.941,13076158,15462563,-15.433,128855382,Biotechnology
NIO,10,5,5,0,0,62.04,62.7,-1.053,184247465,185668315,-0.765,1122001693,Auto Manufacturers
NMTR,10,5,5,0,0,1.28,1.36,-5.882,10138705,6971901,45.422,116682076,Biotechnology
SOLO,10,5,5,0,0,8.87,7.23,22.683,54714322,21960504,149.149,67393926,Auto Manufacturers
ALRN,10,5,5,0,0,1.8,1.92,-6.250,7532396,2483342,203.317,18591664,Biotechnology
AMHG,10,0,10,-10,0,0.65475,0.52,25.913,895045,150350,495.308,14208037,Restaurants
HALB,10,0,10,-10,0,0.0239,0.0235,1.702,11689421,23510582,-50.280,N/A,Biotechnology
BLNK,10,0,10,-10,0,52.31,52.0,0.596,22408971,12000800,86.729,27024784,Specialty Retail
RIOT,10,0,10,-10,0,24.21,22.64,6.935,29022135,23285844,24.634,49501719,Software—Application
VISL,10,0,10,-10,0,1.68,1.69,-0.592,2068706,3062925,-32.460,20796583,Communication Equipment
FSR,10,0,10,-10,0,15.21,14.91,2.012,7857805,12657665,-37.921,133843577,Auto Manufacturers
GLBS,10,0,10,-10,0,6.9,7.05,-2.128,711639,412901,72.351,1473572,Marine Shipping
DGLY,10,0,10,-10,0,2.98,3.07,-2.932,10574967,5665788,86.646,23165606,Security & Protection Services
