Code,Total,Recent,Prev,Change,Rockets,Price,PrvCls,%Change,Volume,3mAvgVol,%ChangeVol,Float,Industry
SNDL,34,24,10,14,0,0.7136,0.6902,3.390,404532901,296296169,36.530,435150917,Drug Manufacturers—Specialty & Generic
HUGE,38,12,26,-14,0,2.07,2.1,-1.429,891403,975763,-8.646,16094672,Drug Manufacturers—Specialty & Generic
BNGO,30,15,15,0,0,8.43,6.95,21.295,232886039,58428415,298.584,151338577,Diagnostics & Research
MLFB,12,12,0,12,0,0.0059,0.0069,-14.493,6923510,5915314,17.044,364383499,Leisure
ONTX,19,19,0,19,0,0.8312,0.7158,16.122,65048979,23052523,182.177,170300364,Biotechnology
VBIV,12,12,0,12,4,3.225,3.22,0.155,25604893,6042555,323.743,161850976,Biotechnology
UAMY,10,5,5,0,0,0.7051,0.6953,1.409,7166727,3210357,123.238,54342051,Other Industrial Metals & Mining
OBSV,19,19,0,19,0,4.07,2.52,61.508,140538597,1195961,11651.102,37697945,Biotechnology
OPTI,10,10,0,10,0,0.10875,0.108,0.694,27555676,54347571,-49.297,9588625,Auto Parts
URG,27,22,5,17,0,1.07,1.19,-10.084,8705855,1865314,366.723,163971928,Uranium
TANH,29,22,7,15,0,1.81,1.97,-8.122,6001121,4169606,43.925,19392496,Household & Personal Products
ZOM,29,10,19,-9,23,0.9751,1.01,-3.455,129714067,126968936,2.162,501007409,Drug Manufacturers—Specialty & Generic
TLSS,25,20,5,15,0,0.061,0.06295,-3.098,79380738,43959671,80.576,1557067013,Trucking
CBBT,68,47,21,26,6,0.12,0.123,-2.439,21806990,27619837,-21.046,139831874,Biotechnology
XELA,10,10,0,10,0,0.828,0.777,6.564,26630802,9413152,182.911,60467885,Software—Application
GAXY,25,15,10,5,0,0.0264,0.02537,4.060,117754094,89927120,30.944,2241222125,Information Technology Services
STHC,13,13,0,13,0,0.1231,0.04,207.750,54627722,6118922,792.767,N/A,Real Estate Services
CTRM,19,5,14,-9,0,0.3356,0.36,-6.778,160070114,59415001,169.410,130854166,Marine Shipping
GMEV,21,21,0,21,5,0.0019,0.0016,18.750,223916325,85860037,160.792,N/A,Pollution & Treatment Controls
RTON,22,22,0,22,4,0.0005,0.0005,0.000,92738416,153720758,-39.671,772160990,Packaged Foods
BIOL,15,15,0,15,0,0.833,0.9141,-8.872,35843063,21239282,68.758,84361084,Medical Devices
ASTI,20,13,7,6,9,0.01185,0.008735,35.661,609564435,107191678,468.668,4031273622,Solar
FRSX,20,10,10,0,0,7.82,6.58,18.845,51858785,10916825,375.035,32365360,Auto Parts
NOVN,15,15,0,15,0,1.27,1.0,27.000,105691320,14317646,638.189,128855382,Biotechnology
OMEG,14,7,7,0,9,10.59,10.62,-0.282,156485,600650,-73.947,N/A,Shell Companies
NAKD,10,5,5,0,0,0.4539,0.4686,-3.137,82298379,138626652,-40.633,41611144,Apparel Manufacturing
AVGR,19,19,0,19,0,1.47,1.11,32.432,132176104,16801553,686.690,84593431,Medical Devices
GRSO,22,22,0,22,0,0.0037,0.002,85.000,896811853,74280577,1107.330,N/A,Farm & Heavy Construction Machinery
TNXP,40,25,15,10,0,0.91,0.9564,-4.852,29847017,18948938,57.513,156426899,Biotechnology
CHRA,10,10,0,10,0,3.85,2.71,42.066,29825477,40026,74415.258,7218076,Waste Management
VAL,21,21,0,21,0,0.33,0.33,0.000,235027,1644840,-85.711,0,0
RDGL,21,21,0,21,0,0.25,0.25925,-3.568,9712070,3562011,172.657,222394895,Drug Manufacturers—Specialty & Generic
NXTD,40,30,10,20,0,1.3,1.395,-6.810,7324609,23840995,-69.277,31844702,Security & Protection Services
ITP,12,12,0,12,8,0.571,0.7281,-21.577,42376605,2836687,1393.877,23101563,Paper & Paper Products
RIOT,10,5,5,0,0,25.78,28.9,-10.796,28123203,24385838,15.326,49501719,Software—Application
MARA,10,5,5,0,0,22.39,24.44,-8.388,32917950,33965752,-3.085,47206070,Capital Markets
SENS,63,38,25,13,9,1.58,1.2,31.667,199232734,7262620,2643.263,114087574,Diagnostics & Research
ALPP,20,5,15,-10,28,2.8,2.72,2.941,1820847,3649525,-50.107,110944403,Electronic Components
ATVK,22,22,0,22,0,0.265,0.241,9.959,20020044,20927579,-4.337,64874451,Specialty Industrial Machinery
SHMP,12,7,5,2,0,0.42025,0.4355,-3.502,4634552,5284360,-12.297,525437373,Farm Products
OZSC,31,11,20,-9,0,0.03065,0.0347,-11.671,485072275,102672094,372.448,N/A,Medical Instruments & Supplies
AMTX,12,7,5,2,0,3.62,3.5,3.429,8256168,2099212,293.298,14248894,Oil & Gas Refining & Marketing
IPO,10,10,0,10,0,68.27,69.52,-1.798,387126,405582,-4.550,N/A,N/A
EMBI,21,0,21,-21,6,0.09,0.0885,1.695,6962748,3799252,83.266,117092343,Biotechnology
SHIP,10,0,10,-10,0,0.8099,0.83,-2.422,7652909,8916831,-14.175,61934365,Marine Shipping
BBI,10,0,10,-10,0,1.1,1.1,0.000,1874250,3200739,-41.443,51984933,Biotechnology
CHNC,10,0,10,-10,0,0.0057,0.00635,-10.236,349930265,88214872,296.679,N/A,Drug Manufacturers—Specialty & Generic
APHA,10,0,10,-10,0,12.42,12.11,2.560,53477431,12766926,318.875,286679615,Drug Manufacturers—Specialty & Generic
IDEX,17,0,17,-17,0,3.18,3.3,-3.636,81798267,41887763,95.280,200267564,Software—Application
LXRX,10,0,10,-10,0,6.87,8.05,-14.658,16952611,10503365,61.402,107118229,Biotechnology
DPW,15,0,15,-15,0,5.23,5.6,-6.607,7911626,12319006,-35.777,16304692,Electrical Equipment & Parts
IZEA,10,0,10,-10,0,3.205,3.19,0.470,7922278,5187930,52.706,45356907,Internet Content & Information
UAVS,10,0,10,-10,0,10.01,9.45,5.926,9775871,5928468,64.897,52210170,Aerospace & Defense
IONI,19,0,19,-19,0,0.65,0.75,-13.333,924864,272557,239.329,21216475,Software—Application
